0000000000
0000000000
0111111110
0111111110
0222222220
0000000000
0000000000
0000000000
0000000000
0000000000