1111111111
1111111111
1111111111
1111111111
1118008111
1118008111
8888008888
0000000000
0000000000
0000000000